111111111111111111111111111111111111111111111111111111111111111
1000000000000000000000000000000000000000000000000000000000000011111
10000000000000000P000000000000000000000000000000000000000000001
100000000000000000000000000000000000001000000000000000000000001
100000000000000000000000000000000000000000000000011111111111111
1000000000E0000000000000000000000000000000000000000000000000001
1000000000000000000000000000000000000000000C1000000000000000001
111111111111111111111111111111111111111111111111111111111111111

