111111111111111111111111111111111111111
10000000000000000000000000C00000000E001
1000000000000000C00000000000000C0000000
111111111111111111111111111111111111111