11111111111111111111111111111111111111111111111111111111111111111
10000000000000000000000000000000000000000000000000000000000000001
1000000000000000000P00000000000000000000000C000000000000000000001
10000000000000000000000000000000000000000000000000000000000000001
10000000000000000111111111111111000000000000000001100000000000011
101000000000000001100001111111111111111111000000C0000000000000001
10000E00000000000000000000000C00000000000000000000000000000000001
11111111111111111111111111111111111111111111111111111111111111111
